########
# ## # #
# #  ##@
$ #### #
  #  ###
### ## #
